R 1080 800

NO ./textures/stone_bricks_north.xpm
SO ./textures/stone_bricks_south.xpm
WE ./textures/stone_bricks_west.xpm
EA ./textures/stone_bricks_east.xpm

S ./textures/steve64x64.xpm

C 17,120,100
F 72,201,176

11111111111111111111111111111
1000000000100000000000000001
10110000011100000000000010001
10010000000000000000000010001
10110000011100000000000010011
10000000001100000111011110001
11110111111111011100000010001
11110111111111011101010010001
11000000110101011100000010001
10000000000000001100000010001
10000000000000001101010010001
10000000000000001101010010N01
11000000110101011111011110001
11110111111101011111011110001
11111111111111111111111111111
10000000000000001100000010001
10000000000000001101010010001
11111111111111111111111111111
