R 1000 800

NO ./textures/stone.xpm
SO ./textures/stonebrick_cracked.xpm
WE ./textures/stonebrick_mossy.xpm
EA ./textures/stonebrick.xpm

S ./textures/zombie64x64.xpm

C 132,241,248
F 123,190,81

        1111111111111111111111111
        1000000000000000000020001
        1100000000000000000002001
        1000000000000000000000001
111111111000000000000000000000001
100000000000000000000000000001111
10000000000000010000000000001
10002000000000000000000000001
10000000000000W00000000000001
10002000000000000000000022001
10000000000000000001010000001
11020001110101011111011110101
11110111 1110121 101111010001
11111111 1111111 111111111111