R  1500 800

NO ./textures/stone_bricks_north.xpm
SO ./textures/stone_bricks_south.xpm
WE ./textures/stone_bricks_west.xpm
EA ./textures/stone_bricks_east.xpm

S ./textures/steve64x64.xpm

C 17,120,100
F 72,201,176

111111111
100000001
100000001
100E00001
100000001
100000011
111111111

