R  1500 800

NO ./textures/stone_bricks_north.xpm
SO ./textures/stone_bricks_south.xpm
WE ./textures/stone_bricks_west.xpm
EA ./textures/stone_bricks_east.xpm

S ./textures/steve64x64.xpm

C 17,120,100
F 72,201,176

11111111111111
10000000000001
10000000000001
1000000S000001
10000000000001
10000000000001
11111111111111

