R 800 600

NO ./textures/stone.xpm
SO ./textures/stonebrick_cracked.xpm
WE ./textures/stonebrick_mossy.xpm
EA ./textures/stonebrick.xpm

S ./textures/zombie64x64.xpm

F 14,153,15
C 255,255,255

       1111111111111111111111111
       1000000000000000000000001
       1100000000000000000000001
       10000000000000000000000011111111
111111111000000000000000000000001
100000000000000000000000000001111
10000000000000N00000000000001
10000000000000000000000000001
10000000000000000000000000001
10000000000000000000000000001
10000000000000000001010000001
11000001110101011111011110101
11110111 1110121 101111010001
11111111 1111111 111111111111
