R 800 600

NO ./textures/stone.xpm

SO ./textures/stonebrick_cracked.xpm
WE ./textures/stonebrick_mossy.xpm
S ./textures/zombie64x64.xpm
EA ./textures/stonebrick.xpm

F 14,180,15
C 90,90,230

     1111111111111111111111111111111111
     1000000000000000000000000000000001
     1100000000000000000000001111111111
     1000000000000000000000001
111111000000000000000000000001
100000000000000000000000111111
10000000000000010000000000001
10020000000000000000000000001
1000N000011110000000000000001
1000000001  10000000000000001
10000000011110000001010000001
11000000000101000001011110101
11110111111101000001111010001
11111111111111111111111111111
