R 1080 800

NO ./textures/stone.xpm
SO ./textures/stonebrick_cracked.xpm
WE ./textures/stonebrick_mossy.xpm
EA ./textures/stonebrick.xpm

S ./textures/steve64x64.xpm

C 94,225,255
F 118,187,95

11111111111111111111111111111
10000000001000000000000000011
10110000000000000000000000001
10010000000200001000020000001
10110000000000000000000000011
10000000200000000000000000001
11110000000000000000000000001
11110111111111000000000000001
11000000110101000000000010001
10000000000000000000000010001
10000000000000000001010000001
10000200000000001101010000N01
11000000110000011111000000001
11000000000000111110111100011
10000000000000000000000000001
10000000000000000000000010001
10000000000000000001010010001
10000000200020000000000000201
10000000000000000000000010001
10000000000020000001010010001
10000000000000000000000000001
10000000000000001000000010001
10000000000000000000010010001    111
10000000000000000000000000001    101
100000000000000000000000100001111101
100000000000000010010100100000000001
111111111111111111111111111111111111
