R 800 600

NO ./textures/stone.xpm
SO ./textures/stonebrick_cracked.xpm
WE ./textures/stonebrick_mossy.xpm
EA ./textures/stonebrick.xpm

S ./textures/zombie64x64.xpm

F 118,187,95
C 94,225,255

11111111111111111111111111111
10000000001000000000000000011
10110000000000000000200000001
10010000002000000000000000001
10110000000000000200000000011
10000000002000000000000000001
11110000000000000000000000001
11110111111111000000200000201
11000000110101000000000010001
10000000000000000000000010001
10000000000000000001010000001
10000000000000001111010000001
11000000110000011  1000000001
11000000000000111  1111100011
10000000000000001111000000001
10000000000000000000000010001
10000000000000000001010010021
100000000000N0000000000000001
10000000000000000000000010001
10000000000000000001010010001
10002000020000000000000000001
10000000000000001000000010001
10000000000000000000010010001    111
10000000000000000000000000001    101
100000000000000000000000100001111101
100000000000000010010100100000000001
111111111111111111111111111111111111
