R  1500 800

NO textures/stone_bricks_north.xpm
SO textures/stone_bricks_south.xpm
WE textures/stone_bricks_west.xpm
EA textures/stone_bricks_east.xpm

S textures/steve64x64.xpm

C 17,120,100
F 72,201,176

11111111111111111111
10000000001000000001
100000000010S00001001
100011000010001111101
100011000010000001001
10000000000111100101
10010000000000000101
10000000000000000001
1000000010000000001
100000000000000001
111111111111111111
