R 1920 1080

NO textures/stone_bricks_north.xpm
SO textures/stone_bricks_south.xpm
WE textures/stone_bricks_west.xpm
EA textures/stone_bricks_east.xpm

S textures/steve64x64.xpm

C 245,24,24
F 123,173,249

11111111111111111111111
10000001100000000000001
10000000000000000010001
10000000001100000000001
10000110000000000000011
10000000S00111000011001
10011100000000001000001
10000000011000001100001
10000000000000000000001
10000000001100000000001
10000000000000000000001
11111111111111111111111
