R 800 800

NO ./textures/stone.xpm
SO ./textures/stonebrick_cracked.xpm
WE ./textures/stonebrick_mossy.xpm
EA ./textures/stonebrick.xpm

S ./textures/zombie64x64.xpm

C 132,241,248
F 123,190,255

        1111111111 1111111111111111
        100000000010000000002000001
        110000000000000000000200111
        10000000000000000000000001
1111111110000000000000000000000011
100000000000000000000000000001111
10000000000000010000000000001
10002000001111100000000000001
1000000001     10000000000001
1000200000111110E000000022001
10000000000000000001010000001
11020001110101011111011110101
11110111 11101210101111010001
11111111111111111111111111111